111111111
100010C01
10P010001
10C011EE1
100000001
111111111